...####################################################################################################################################################
...#..#........#.....#...........#...........#..............#..#.....#.....#.....#..#..#.......................#........#.....#........#.....#........#
#..#..#..####..####..#..#..################..####..####..#..#..#..####..#..####..#..#..#..#######..#..################..#..##########..#..####..####..#
#..#..#.....#..#........#.....#..#.....#...........#.....#..#...........#.....#.....#........#.....#.....#..#..............#....................#..#..#
#..#..#..####..####..####..####..#..#..#..#######..####..####..#..####..##########..#######..#..#..####..#..#..#..#######..####..#..##########..#..####
#...........#..#........#..#..#.....#.....#.....#..#..#..#..#..#.....#..#.....#..#........#..#..#..#..#.....#..#..#........#.....#........#..#........#
####..#######..#######..#..#..#######..####..#..####..#..#..#..####..#..#..#..#..####..####..#..####..#..#..#######..####..####..####..#..#..####..####
#........#.....#..#..#..#.....#..#..#........#.....#..#..#..#..#..#..#..#..#..#...........#..#.....#..#..#..#.....#.....#..#.....#.....#.....#........#
#..##########..#..#..#######..#..#..####..#..####..#..#..#..#..#..#######..####..#######..####..#..#..#######..#..#..####..####..####..####..####..####
#...........#.....#........#.....#........#.....#..#..............#...........#.....#..#........#..#..#.....#..#..#..#..#..#.....#........#..#........#
#..#..#######..#..#..#..#..#..#..#..####..#..#########################..####..#######..#..##########..####..#..#######..#..###################..#######
#..#........#..#.....#..#..#..#..#..#.....#..#..#....................#..#..............#..#..#.....#........#..#..#.....#..#........#..#..#........#..#
#..##########..################..##########..#..####..#..####..#..#######..#..#..#..####..#..####..####..####..#..#..#..#..#..#######..#..####..#..#..#
#...........#..#.....#........#..............#.....#..#.....#..#..#........#..#..#.....#....................#..#..#..#..#...........#........#..#.....#
#..####..#..#######..#######..#..#######..#..####..#..####..#######..####..##########..#..#..####..#..#..#..#..#..####..####..####..#..#######..#######
#.....#..#..............#.....#.....#.....#...........#..#..#..#........#..#..#..#........#..#.....#..#..#..#.....#..#........#...........#...........#
#..#######..#######..####..##########..#..#..#..#######..#..#..#..##########..#..#..####..#######..#..#######..#..#..##########..####..####..##########
#..#..#..#.....#........#..............#..#..#..#..#..............#........#.....#..#..#..#.....#..#..#........#.....#..#...........#..#...........#..#
#..#..#..#..###################..#..#######..####..#..####..#..#..#..##########..#..#..####..#######..#..##########..#..#######..#######..#######..#..#
#.....#.....#...........#.....#..#..#.....#........#..#.....#..#..#........#........#........#........#........#..#.....#..............#..#.....#..#..#
#######..#############..#..#..#..####..#..##########..#..##########..####..##########..#..#######..##########..#..#..#..#..#..#######..#######..#..#..#
#...........#...........#..#..#.....#..#..#........#..#..#.....#.....#.....#.....#.....#...........#..#........#.....#..#..#........#..#.....#........#
#..#############..#..####..#######..#..####..#..#######..#..#..#..####..#..#..####..#..#######..####..#######..#..####..#..#..#..#..####..#..#..#######
#.................#........#.....#.....#.....#.....#........#........#..#..#..#..#..#.....#........#........#..#.....#..#..#..#..#........#...........#
#..#..####..####..#..#######..####..#..####..#..#..################..####..#..#..#..#..################..#..####..##########..#############..#..####..#
#..#..#.....#..#..#.....#........#..#........#..#..#.....#.....#........#..#........#..#..............#..#..#..............#........#..#..#..#..#.....#
#..####..#..#..#..#######..#######..##########..#######..#..#############..#############..#######..#######..####..####..####..#..####..#..#######..#..#
#.....#..#..#..........................#.................#..#..#..#........#.....#.....#.....#..#..#........#..#.....#........#........#..#........#..#
###################..####..####..#############..#######..#..#..#..####..#..#..#..####..#..#..#..#######..####..#..#######..#..##########..#..####..#..#
#..#..#.....#........#.....#..#..#....................#..#........#.....#.....#..#........#..............#..............#..#........#.....#..#.....#..#
#..#..####..#..####..#######..##########..#######..####..#######..#######..#######..#######..####..#..#..#..#..#..##########..####..####..#..#######..#
#..............#.....#...........#........#.....#.....#..#..#.....#.....#.....#...........#..#.....#..#.....#..#........#.....#........#........#.....#
####..####..#..#######..#######..#..#..#..#..####..####..#..#..#..#..#..#..#..#..####..####..#..##########..#########################..#############..#
#.....#.....#.....#..#..#........#..#..#..#..#.....#.....#.....#..#..#.....#..#..#.....#.....#.....#..#.....#..#.................#........#..#........#
####..####..#..#..#..#..####..#############..#..##########..#..#######..#######..#..#..#..#..#######..####..#..#..##########..####..#######..#..#..#..#
#..#.....#..#..#..#........#........#.....#..#........#.....#........#........#..#..#..#..#..#..#..#..#........#..#...........#..#.....#..#..#..#..#..#
#..#..#..####..#######..#..#..#######..####..#############..#######..#############..#..#######..#..#..#######..#..#..#..####..#..#..####..#..##########
#.....#..#..............#..#..#................................#..#.....#..#..#.....#.....#.....#.................#..#..#........#.....#........#.....#
#..######################..##########..##########..#..#..####..#..#######..#..#..####..#..####..####..#######..####..#..#..####..##########..#######..#
#.....#........#...........#..#..#.....#...........#..#..#.....#........#..#.....#.....#..#..#.....#..#...........#..#..#..#..#.....#..#..#.....#..#..#
#..####..####..##########..#..#..####..#######..#############..#..#######..#############..#..#..#######..###################..#..####..#..####..#..#..#
#..#..#..#.....#.....#........#..#...........#..#..#..#..............#........#..#........#..#.....#..#.....#.....#..#..#.....#........#.....#........#
#..#..####..####..####..####..#..####..##########..#..#..##########..####..####..#..#..####..#..#..#..####..#..#..#..#..####..#..#######..##########..#
#..#..#.....#..#...........#.....#.....#.....#...........#.....#.....#........#..#..#..#.....#..#..#...........#........#..#..#.....#.....#...........#
#..#..#..####..#..#..#######..#..#######..#..#..####..#..#..#############..#..#..#######..#..####..#######..#..#######..#..#..#######..##########..####
#.....#..#........#........#..#..#........#........#..#.....#..............#..#........#..#........#........#..#...........#..#.....#.................#
####..#..#######..#..#..####..#############..##########..###################..####..####..####..####..#..#############..####..#..####..####..##########
#..#.....#........#..#.....#..#..#..#.....#..#........#..#.....#..#.....#.....#.....#..#..#...........#........#........#..#........#..#...........#..#
#..####..####..#..####..#######..#..#..####..#######..#..#..#..#..#..####..####..#..#..####..#..####..###################..#..#######..##########..#..#
#...........#..#..#.................#.....#...........#.....#..#...........#.....#.....#..#..#..#.......................#...........#..#..#.....#..#..#
#############..#..#..#..#######..####..#..#..################..#..#..####..####..####..#..#######..#######..####..#..#############..####..####..#..#..#
#..#........#..#..#..#..#.....#..#.....#..#.....#.................#..#.....#.....#..............#.....#........#..#..#..#..#.....#........#...........#
#..####..#..#..#############..####..#..##########..#######..#############..####..#..#######..#######..#############..#..#..#..#######..#..##########..#
#..#..#..#.....#..#.....#..#.....#..#..#.....#........#...........#..#..#..#.....#.....#.....#........#.....#........#.....#...........#........#.....#
#..#..#..####..#..####..#..#..####..#..#..####..##########..####..#..#..#######..##########..####..#..#..#..#..#..####..####..#..#..#..####..####..#..#
#..#.....#..#..#...........#........#........#..#.....#........#........#.....#........#.....#.....#.....#..#..#..............#..#..#.....#..#.....#..#
#..####..#..#..#..#..#..#######..################..####..#..#..####..#..#..#######..#######..####..################..##########..#..#######..####..#..#
#...........#..#..#..#........#...........#..............#..#..#.....#..#.....#.....#..............#.....#..#...........#..#.....#........#........#..#
#..####..####..#######..##########..####..#..####..####..####..####..#######..#######..#############..#..#..#..#..####..#..####..##########..####..####
#..#..#..#..#.......................#........#.....#.....#..#..#..#...........#..#..#...........#.....#........#.....#..#.....#.....#..#..#.....#.....#
#..#..#..#..####..#######..#######..#######..#############..#..#..####..#..#..#..#..#..#..#..####..#..#..#############..#..####..####..#..#######..####
#..#.....#........#..#...........#..#..#..............#..#..#.....#.....#..#..#..#.....#..#..#.....#..#........#.....#..#.....#...........#.....#..#..#
#..####..####..#..#..#######..####..#..####..#######..#..#..#######..#..#######..#..##########..####..####..#..#..####..####..##########..####..####..#
#..#........#..#..#...........#.....#..#.....#.....#........#..#.....#.....#...........#.....#.....#..#.....#..#...........#.....#..#........#..#.....#
#..#..#######..#..#######..####..####..##########..#..#..#..#..#..#..#############..#######..#######..################..#######..#..#..#..####..#..####
#..#.....#..#..#..#..#.....#..............#.....#.....#..#..#.....#..#...........#..#.....#..#...........#.....#..#...........#........#..#...........#
#..#######..####..#..#..#..##########..####..####..#######..####..#######..##########..####..##########..####..#..#..#..####..#######..#..####..####..#
#..#........#........#..#...........#.....#...........#.....#...........#..#.....#........#.....#..#.....#...........#..#..#..#........#.....#.....#..#
#..####..#######..####..###################..####..####..####..#..####..#..#..####..#######..####..####..#..#..#..#######..####..#######..#..#..####..#
#..#...........#..#........#.....#..#.....#.....#..#..#.....#..#..#..#.....#.......................#..#..#..#..#..............#..#........#..#..#..#..#
#############..#######..#..#..####..####..#..#######..#######..####..#..####..#..#..#############..#..#..#..####..####..####..################..#..#..#
#..#..#..#.....#..#..#..#..#.................#.....#........#.....#........#..#..#...........#..#..#.....#..#.....#..#..#..#.......................#..#
#..#..#..#..#..#..#..#..#..####..#######..#######..#######..##########..####..#..#..#..#..####..#..#############..#..####..#..#..##########..#..#######
#...........#..#........#..#.....#..#........#.....#..#........#...........#..#..#..#..#.....#.....#..#.....#..#.....#........#.....#..#.....#.....#..#
#######..#..###################..#..#######..####..#..#..##########..#..#######..#############..####..####..#..####..#..##########..#..#..#######..#..#
#........#..#.....#.....#........#..#..#....................#.....#..#.....#..#..#........#..#.....#.....#...........#...........#..#..#.....#........#
#..##########..#######..##########..#..#..#..#..####..#..#######..#..####..#..#..#..#..####..####..#..#..#..####..####..##########..#..#############..#
#.....#...........#.....#..#..#...........#..#..#.....#..#........#..#..............#.....#........#..#..#.....#..#.....#..#........#...........#.....#
#..#..#######..####..####..#..#..#######..#..#..####..#..####..#..#..####..####..#..#..#######..#..#..#..#..#..##########..#..#..##########..#######..#
#..#..#.....#..#..#..............#........#..#.....#..#..#.....#..#.....#.....#..#..#.....#.....#.....#.....#........#........#..#.....#........#.....#
####..####..#..#..#..##########..####..#######..#######..####..#######..#########################..#######..#############..#..####..####..#############
#..............#..#........#.....#..#..#.....#.....#..#.....#..............#.................#...........#..#.....#.....#..#..#.................#..#..#
#..####..#######..#..#######..####..#..#..####..####..#######..#..#..#..####..#..####..#..####..####..##########..####..#..#..#..##########..####..#..#
#.....#........#........#..#.....#..#.....#........#...........#..#..#..#.....#..#..#..#..#..#..#..#..#..#........#........#.....#..#.....#..#..#.....#
#######..################..#######..#..#..#######..####..####..#..####..####..####..####..#..####..####..#..#..#..#######..####..#..#..####..#..#..#..#
#.....#..#.....#..#...........#........#.....#.....#..#..#..#..#..#..#..............#..#........#.....#.....#..#...........#..#..#.....#...........#..#
####..#..####..#..####..#######..#..####..##########..#..#..#######..#..#############..#######..#..##########..####..#..####..#..#..#..##########..####
#.......................#.....#..#..#...........#..#...........#..#........#..#.....#..............#.....#.....#..#..#.....#..#.....#.....#.....#.....#
####..#..#######..##########..####..#######..####..#############..#..#######..#..##########..##########..#######..#..####..#..#############..#..#######
#.....#..#.....#..............#........#..#........#..#..#..#..#..#.....#..#..#..#........#........#.....#.....#........#...........#..#.....#........#
#..####..####..#..####..####..####..####..##########..#..#..#..#..#######..#..#..####..####..####..####..#..####..####..#..#######..#..#######..#######
#..#.....#........#..#..#...........#.....#.....#........#.....#..............#..............#.....#...........#.....#..#........#.....#.....#........#
##########..#..####..#######..####..#..#..#..####..####..#..##########..#..####..#######..#############..####..#..#######..####..####..#..#..#..####..#
#...........#...........#........#.....#........#..#..............#.....#...........#........#........#.....#..#..#.....#..#.....#........#.....#.....#
####..#..#..###################..#..#######..################..#..#..#######..#######..####..#######..#######..####..####..#..#..####..#..#############
#..#..#..#........#.....#..#.....#.....#........#..#........#..#..#.....#........#.....#...........#..#.....#...........#..#..#..#.....#..............#
#..#..####..##########..#..#..####..#..#..####..#..#..#..####..#..#############..#######..##########..#..####..#..#..####..#..#..#..#..#..#..#######..#
#.....#.....#..#........#........#..#..#..#...........#........#..#..#.....#........#.................#........#..#.....#..#..#..#..#..#..#..#........#
#..##########..#..####..####..#..#..####..####..####..#..####..#..#..#..#..####..#..####..#..####..####..#############..#..#..####..#..####..####..####
#.................#........#..#..#..#........#..#.....#.....#..#..#.....#........#.....#..#.....#.................#.....#..#.....#..#.....#..#.........
####################################################################################################################################################...
